
北京	链家房产	我爱我家	鑫尊
上海	中原	德佑	21世纪
深圳	中原	满堂红	家家顺
广州	中原	满堂红	家家顺
沈阳	沈阳芒果地产代理有限公司	沈阳瑞家地产有限公司	沈阳屹城房地产经纪有限公司
大连	大连好旺角房屋经纪有限公司	瑞家装饰（大连）地产代理有限公司	大连链家房地产经纪有限公司
长春	长春房屋置换股份有限公司	长春市协力房地产经纪有限公司	长春新发房地产经纪有限公司
哈尔滨	骄阳地产	好家庭房地产	大盛地产
呼和浩特	呼和浩特兴麟房地产公司	呼和浩特房老大房地产公司	呼和浩特京城广厦房地产公司
南京	伟业我爱我家集团	南京利众房屋销售有限公司	南京链家房地产经纪有限公司
苏州	我爱我家	顺驰	泰山
徐州	徐州美房地壹房屋置换经纪有限公司	徐州市宝泰房产经纪有限公司	徐州徐房房屋置换经纪有限公司
无锡	无锡顺驰不动产网络有限公司	无锡市大众房地产服务连锁服务有限公司	无锡市锡城中山房产服务有限公司
福州	福州麦田房产代理有限公司	福州骊特房产代理有限公司	福州金海岸房产代理有限公司
厦门	置强房产	丹厦房产	麦田房产
杭州	杭州我爱我家房地产	华邦地产	盛世管家
宁波	21世纪不动产	南天房产	甬旺房产
重庆	钢运房产	大业兴	伊诚房产
昆明	新亚房产	荣城	尊园
成都	伊诚地产	满堂红	链家地产
东莞	满堂红	中原物业	家家顺
长沙	长沙新环境房地产经纪连锁有限公司	长沙嘉业房地产顾问有限公司	湖南中联房地产顾问有限公司
海口	万紫千红	房田房屋（新环境）	星福房产
南宁	南宁市恒创房地产经纪有限公司	广西桂人房地产策划代理有限公司	广西江山房地产咨询代理有限公司
武汉	湖北深中联置业	21世纪不动产（武汉）	壹加贰联合不动产（武汉）
宜昌	宜昌恒大地产代理	宜昌昊天置业	宜昌信宜房地产经纪有限公司
郑州	二十一世纪	世家房产	思德良行
合肥	安徽中皖辉达房地产代理销售有限公司	合肥零五五一房产网络营销有限公司	合肥吉大房地产
青岛	链家房产	惠百家	21世纪
烟台	正大房产	玛雅房屋	筑家房产
威海	鲁威房产	儒房房产	盛兴房产
济南	济南齐鲁楼市不动产有限公司	济南玛雅不动产有限公司	济南哈考特不动产
潍坊	潍坊恒信	潍坊鑫锦盛	潍坊二十一世纪
淄博	淄博锡恩房地产	淄博汇隆房地产	淄博宗氏房地产
临沂	新天地房产	鲁房置换	报媒不动产
天津	天津市我爱我家房地产经纪有限公司	天津中原物业顾问有限公司	天津链家宝业房地产经纪有限公司
乌鲁木齐	玛雅房屋	海汇房产	顺邦地产
兰州	玛雅房屋	海汇房产	
太原	我爱我家	易佳	龙城居业
石家庄	正大	国大	壹加贰
西安	玛雅房屋	海汇房产	顺邦地产
银川	银川佳运房产中介代理	银川新朋友房产代理	银川盛世家源房产代理
