domain	short_name
sjz.ganji.com	石家庄
tangshan.ganji.com	唐山
qinhuangdao.ganji.com	秦皇岛
handan.ganji.com	邯郸
xingtai.ganji.com	邢台
baoding.ganji.com	保定
zhangjiakou.ganji.com	张家口
chengde.ganji.com	承德
cangzhou.ganji.com	沧州
langfang.ganji.com	廊坊
hengshui.ganji.com	衡水
bj.ganji.com	北京
sh.ganji.com	上海
tj.ganji.com	天津
cq.ganji.com	重庆
gz.ganji.com	广州
sz.ganji.com	深圳
zhuhai.ganji.com	珠海
shantou.ganji.com	汕头
foshan.ganji.com	佛山
jiangmen.ganji.com	江门
maoming.ganji.com	茂名
huizhou.ganji.com	惠州
dg.ganji.com	东莞
zhongshan.ganji.com	中山
hz.ganji.com	杭州
nb.ganji.com	宁波
wenzhou.ganji.com	温州
jiaxing.ganji.com	嘉兴
huzhou.ganji.com	湖州
shaoxing.ganji.com	绍兴
jinhua.ganji.com	金华
quzhou.ganji.com	衢州
zhoushan.ganji.com	舟山
zjtaizhou.ganji.com	台州
gy.ganji.com	贵阳
liupanshui.ganji.com	六盘水
zunyi.ganji.com	遵义
anshun.ganji.com	安顺
tongren.ganji.com	铜仁
bijie.ganji.com	毕节
qianxinan.ganji.com	黔西南
qiandongnan.ganji.com	黔东南
qiannan.ganji.com	黔南
cd.ganji.com	成都
zigong.ganji.com	自贡
luzhou.ganji.com	泸州
deyang.ganji.com	德阳
mianyang.ganji.com	绵阳
leshan.ganji.com	乐山
nanchong.ganji.com	南充
yibin.ganji.com	宜宾
dazhou.ganji.com	达州
liangshan.ganji.com	凉山
sy.ganji.com	沈阳
dl.ganji.com	大连
anshan.ganji.com	鞍山
fushun.ganji.com	抚顺
dandong.ganji.com	丹东
jinzhou.ganji.com	锦州
yingkou.ganji.com	营口
liaoyang.ganji.com	辽阳
panjin.ganji.com	盘锦
huludao.ganji.com	葫芦岛
nj.ganji.com	南京
wx.ganji.com	无锡
su.ganji.com	苏州
xuzhou.ganji.com	徐州
changzhou.ganji.com	常州
nantong.ganji.com	南通
lianyungang.ganji.com	连云港
huaian.ganji.com	淮安
yancheng.ganji.com	盐城
yangzhou.ganji.com	扬州
fz.ganji.com	福州
xm.ganji.com	厦门
putian.ganji.com	莆田
sanming.ganji.com	三明
quanzhou.ganji.com	泉州
zhangzhou.ganji.com	漳州
nanping.ganji.com	南平
longyan.ganji.com	龙岩
ningde.ganji.com	宁德
cc.ganji.com	长春
jilin.ganji.com	吉林
siping.ganji.com	四平
liaoyuan.ganji.com	辽源
tonghua.ganji.com	通化
baishan.ganji.com	白山
songyuan.ganji.com	松原
baicheng.ganji.com	白城
yanbian.ganji.com	延边
hrb.ganji.com	哈尔滨
qiqihaer.ganji.com	齐齐哈尔
jixi.ganji.com	鸡西
hegang.ganji.com	鹤岗
shuangyashan.ganji.com	双鸭山
daqing.ganji.com	大庆
hljyichun.ganji.com	伊春
jiamusi.ganji.com	佳木斯
heihe.ganji.com	黑河
suihua.ganji.com	绥化
zz.ganji.com	郑州
luoyang.ganji.com	洛阳
pingdingshan.ganji.com	平顶山
jiaozuo.ganji.com	焦作
hebi.ganji.com	鹤壁
xinxiang.ganji.com	新乡
anyang.ganji.com	安阳
luohe.ganji.com	漯河
nanyang.ganji.com	南阳
jiyuan.ganji.com	济源
jn.ganji.com	济南
qd.ganji.com	青岛
zibo.ganji.com	淄博
zaozhuang.ganji.com	枣庄
dongying.ganji.com	东营
yantai.ganji.com	烟台
weifang.ganji.com	潍坊
wei.ganji.com	威海
laiwu.ganji.com	莱芜
binzhou.ganji.com	滨州
hf.ganji.com	合肥
wuhu.ganji.com	芜湖
bengbu.ganji.com	蚌埠
maanshan.ganji.com	马鞍山
anqing.ganji.com	安庆
chuzhou.ganji.com	滁州
fuyang.ganji.com	阜阳
ahsuzhou.ganji.com	宿州
chaohu.ganji.com	巢湖
luan.ganji.com	六安
liuzhou.ganji.com	柳州
gl.ganji.com	桂林
wuzhou.ganji.com	梧州
qinzhou.ganji.com	钦州
guigang.ganji.com	贵港
gxyulin.ganji.com	玉林
baise.ganji.com	百色
hechi.ganji.com	河池
laibin.ganji.com	来宾
nn.ganji.com	南宁
hn.ganji.com	海口
sanya.ganji.com	三亚
nmg.ganji.com	呼和浩特
baotou.ganji.com	包头
wuhai.ganji.com	乌海
chifeng.ganji.com	赤峰
tongliao.ganji.com	通辽
eerduosi.ganji.com	鄂尔多斯
hulunbeier.ganji.com	呼伦贝尔
bayannaoer.ganji.com	巴彦淖尔
wulanchabu.ganji.com	乌兰察布
xingan.ganji.com	兴安
ty.ganji.com	太原
datong.ganji.com	大同
yangquan.ganji.com	阳泉
changzhi.ganji.com	长治
jincheng.ganji.com	晋城
shuozhou.ganji.com	朔州
jinzhong.ganji.com	晋中
yuncheng.ganji.com	运城
xinzhou.ganji.com	忻州
linfen.ganji.com	临汾
yc.ganji.com	银川
lz.ganji.com	兰州
jinchang.ganji.com	金昌
baiyin.ganji.com	白银
tianshui.ganji.com	天水
wuwei.ganji.com	武威
zhangye.ganji.com	张掖
pingliang.ganji.com	平凉
jiuquan.ganji.com	酒泉
qingyang.ganji.com	庆阳
dingxi.ganji.com	定西
xa.ganji.com	西安
tongchuan.ganji.com	铜川
baoji.ganji.com	宝鸡
xianyang.ganji.com	咸阳
weinan.ganji.com	渭南
yanan.ganji.com	延安
hanzhong.ganji.com	汉中
sxyulin.ganji.com	榆林
ankang.ganji.com	安康
shangluo.ganji.com	商洛
xn.ganji.com	西宁
haidong.ganji.com	海东
haibei.ganji.com	海北
huangnan.ganji.com	黄南
hainanzhou.ganji.com	海南州
guoluo.ganji.com	果洛
yushu.ganji.com	玉树
haixi.ganji.com	海西
wh.ganji.com	武汉
huangshi.ganji.com	黄石
xiangyang.ganji.com	襄阳
shiyan.ganji.com	十堰
jingzhou.ganji.com	荆州
yichang.ganji.com	宜昌
jingmen.ganji.com	荆门
ezhou.ganji.com	鄂州
xiantao.ganji.com	仙桃
qianjiang.ganji.com	潜江
cs.ganji.com	长沙
zhuzhou.ganji.com	株洲
xiangtan.ganji.com	湘潭
hengyang.ganji.com	衡阳
shaoyang.ganji.com	邵阳
yueyang.ganji.com	岳阳
changde.ganji.com	常德
chenzhou.ganji.com	郴州
yongzhou.ganji.com	永州
loudi.ganji.com	娄底
nc.ganji.com	南昌
jingdezhen.ganji.com	景德镇
pingxiang.ganji.com	萍乡
jiujiang.ganji.com	九江
xinyu.ganji.com	新余
yingtan.ganji.com	鹰潭
ganzhou.ganji.com	赣州
jian.ganji.com	吉安
jxyichun.ganji.com	宜春
jxfuzhou.ganji.com	抚州
shangrao.ganji.com	上饶
km.ganji.com	昆明
qujing.ganji.com	曲靖
yuxi.ganji.com	玉溪
baoshan.ganji.com	保山
zhaotong.ganji.com	昭通
lijiang.ganji.com	丽江
puer.ganji.com	普洱
lincang.ganji.com	临沧
wenshan.ganji.com	文山
honghe.ganji.com	红河
xishuangbanna.ganji.com	西双版纳
chuxiong.ganji.com	楚雄
dali.ganji.com	大理
dehong.ganji.com	德宏
nujiang.ganji.com	怒江
diqing.ganji.com	迪庆
xj.ganji.com	乌鲁木齐
kelamayi.ganji.com	克拉玛依
tulufan.ganji.com	吐鲁番
hami.ganji.com	哈密
hetian.ganji.com	和田
akesu.ganji.com	阿克苏
kashi.ganji.com	喀什
kezilesu.ganji.com	克孜勒苏
bayinguoleng.ganji.com	巴音郭楞
changji.ganji.com	昌吉
boertala.ganji.com	博尔塔拉
yili.ganji.com	伊犁
tacheng.ganji.com	塔城
aletai.ganji.com	阿勒泰
shihezi.ganji.com	石河子
xz.ganji.com	拉萨
changdu.ganji.com	昌都
shannan.ganji.com	山南
rikaze.ganji.com	日喀则
naqu.ganji.com	那曲
ali.ganji.com	阿里
linzhi.ganji.com	林芝
shaoguan.ganji.com	韶关
zhanjiang.ganji.com	湛江
zhaoqing.ganji.com	肇庆
meizhou.ganji.com	梅州
shanwei.ganji.com	汕尾
heyuan.ganji.com	河源
yangjiang.ganji.com	阳江
qingyuan.ganji.com	清远
chaozhou.ganji.com	潮州
jieyang.ganji.com	揭阳
yunfu.ganji.com	云浮
panzhihua.ganji.com	攀枝花
guangyuan.ganji.com	广元
suining.ganji.com	遂宁
neijiang.ganji.com	内江
guangan.ganji.com	广安
meishan.ganji.com	眉山
yaan.ganji.com	雅安
bazhong.ganji.com	巴中
ziyang.ganji.com	资阳
aba.ganji.com	阿坝
ganzi.ganji.com	甘孜
lishui.ganji.com	丽水
benxi.ganji.com	本溪
fuxin.ganji.com	阜新
tieling.ganji.com	铁岭
chaoyang.ganji.com	朝阳市
zhenjiang.ganji.com	镇江
jstaizhou.ganji.com	泰州
suqian.ganji.com	宿迁
kaifeng.ganji.com	开封
puyang.ganji.com	濮阳
xuchang.ganji.com	许昌
sanmenxia.ganji.com	三门峡
shangqiu.ganji.com	商丘
xinyang.ganji.com	信阳
zhoukou.ganji.com	周口
zhumadian.ganji.com	驻马店
qitaihe.ganji.com	七台河
mudanjiang.ganji.com	牡丹江
daxinganling.ganji.com	大兴安岭
jining.ganji.com	济宁
taian.ganji.com	泰安
rizhao.ganji.com	日照
linyi.ganji.com	临沂
dezhou.ganji.com	德州
liaocheng.ganji.com	聊城
huainan.ganji.com	淮南
huaibei.ganji.com	淮北
tongling.ganji.com	铜陵
huangshan.ganji.com	黄山
bozhou.ganji.com	亳州
chizhou.ganji.com	池州
xuancheng.ganji.com	宣城
beihai.ganji.com	北海
fangchenggang.ganji.com	防城港
hezhou.ganji.com	贺州
chongzuo.ganji.com	崇左
xilinguole.ganji.com	锡林郭勒
alashan.ganji.com	阿拉善
lvliang.ganji.com	吕梁
longnan.ganji.com	陇南
linxia.ganji.com	临夏
gannan.ganji.com	甘南
xiaogan.ganji.com	孝感
huanggang.ganji.com	黄冈
xianning.ganji.com	咸宁
suizhou.ganji.com	随州
enshi.ganji.com	恩施
tianmen.ganji.com	天门
shennongjia.ganji.com	神农架
zhangjiajie.ganji.com	张家界
yiyang.ganji.com	益阳
huaihua.ganji.com	怀化
xiangxi.ganji.com	湘西
heze.ganji.com	菏泽
shizuishan.ganji.com	石嘴山
wuzhong.ganji.com	吴忠
guyuan.ganji.com	固原
zhongwei.ganji.com	中卫
jiayuguan.ganji.com	嘉峪关
xianggang.ganji.com	香港
aomen.ganji.com	澳门
wuzhishan.ganji.com	五指山
kuerle.ganji.com	库尔勒
alaer.ganji.com	阿拉尔
tumushuke.ganji.com	图木舒克
wujiaqu.ganji.com	五家渠
qh.ganji.com	琼海
danzhou.ganji.com	儋州
